Mike Miller	Mike Miller (basketball, born 1980)
Quincy Acy	Quincy Acy
Joe Johnson	Joe Johnson (basketball)
Brook Lopez	Brook Lopez
Davis Bertans	Davis Bertans
DeAndre' Bembry	DeAndre' Bembry
Okaro White	Okaro White
Deron Williams	Deron Williams
Glen Davis	Glen Davis (basketball)
Raul Neto	Raul Neto
Kevin Martin	Kevin Martin (basketball, born 1983)
Rudy Gay	Rudy Gay
Heat	Miami Heat
Marquese Chriss	Marquese Chriss
Spurs	San Antonio Spurs
Justise Winslow	Justise Winslow
Emmanuel Mudiay	Emmanuel Mudiay
Erick Green	Erick Green
E'Twaun Moore	E'Twaun Moore
Josh Richardson	Josh Richardson
Sergey Karasev	Sergey Karasev
Evan Turner	Evan Turner
Isaiah Canaan	Isaiah Canaan
Zoran Dragic	Zoran Dragic
Doug McDermott	Doug McDermott
Ray McCallum	Ray McCallum
Jusuf Nurkic	Jusuf Nurkic
Joel Anthony	Joel Anthony
Cameron Payne	Cameron Payne
Troy Williams	Troy Williams
Henry Sims	Henry Sims
Jarell Eddie	Jarell Eddie
A.J. Price	A.J. Price
Sebastian Telfair	Sebastian Telfair
Francisco Garcia	Francisco García (basketball)
Patty Mills	Patty Mills
Omer Asik	Omer Asik
Kawhi Leonard	Kawhi Leonard
Denzel Valentine	Denzel Valentine
Grizzlies	Memphis Grizzlies
Quincy Miller	Quincy Miller
DeAndre Liggins	DeAndre Liggins
Hollis Thompson	Hollis Thompson
Pelicans	New Orleans Pelicans
Grant Jerrett	Grant Jerrett
Josh McRoberts	Josh McRoberts
Gary Harris	Gary Harris
Jonas Jerebko	Jonas Jerebko
John Henson	John Henson (basketball)
Kendall Marshall	Kendall Marshall
PJ Tucker	PJ Tucker
Adreian Payne	Adreian Payne
Nicolas Batum	Nicolas Batum
Marc Gasol	Marc Gasol
Chase Budinger	Chase Budinger
Cristiano Felicio	Cristiano Felicio
Kevon Looney	Kevon Looney
Rajon Rondo	Rajon Rondo
Pau Gasol	Pau Gasol
Martell Webster	Martell Webster
Brandon Jennings	Brandon Jennings
Dario Saric	Dario Saric
Blake Griffin	Blake Griffin
Reggie Jackson	Reggie Jackson
Malcolm Brogdon	Malcolm Brogdon
Perry Jones III	Perry Jones III
Kevin Durant	Kevin Durant
Joe Ingles	Joe Ingles
Ed Davis	Ed Davis (basketball)
Solomon Hill	Solomon Hill (basketball)
Deyonta Davis	Deyonta Davis
Shane Larkin	Shane Larkin
CJ Watson	CJ Watson
Terry Rozier	Terry Rozier
Carl Landry	Carl Landry
Timofey Mozgov	Timofey Mozgov
Reggie Williams	Reggie Williams (basketball, born 1964)
Robin Lopez	Robin Lopez
Russ Smith	Russ Smith (basketball)
J.J. Barea	J.J. Barea
Troy Daniels	Troy Daniels
Marcus Smart	Marcus Smart
Briante Weber	Briante Weber
Danny Granger	Danny Granger
Aaron Brooks	Aaron Brooks (basketball)
Dwyane Wade	Dwyane Wade
Al-Farouq Aminu	Al-Farouq Aminu
Alan Anderson	Alan Anderson (basketball)
Chris Copeland	Chris Copeland
Al Jefferson	Al Jefferson
Tarik Black	Tarik Black
Chris McCullough	Chris McCullough
Bucks	Milwaukee Bucks
Elfrid Payton	Elfrid Payton (basketball)
LaMarcus Aldridge	LaMarcus Aldridge
Jason Terry	Jason Terry
Patrick McCaw	Patrick McCaw
Rockets	Houston Rockets
Pero Antic	Pero Antic
Jordan McRae	Jordan McRae
Jeff Taylor	Jeff Taylor (basketball)
Domantas Sabonis	Domantas Sabonis
Jon Leuer	Jon Leuer
Mindaugas Kuzminskas	Mindaugas Kuzminskas
Jodie Meeks	Jodie Meeks
Larry Drew II	Larry Drew II
Jerian Grant	Jerian Grant
Yogi Ferrell	Yogi Ferrell
Tristan Thompson	Tristan Thompson
Kyle Anderson	Kyle Anderson (basketball)
Markel Brown	Markel Brown
Austin Daye	Austin Daye
Malachi Richardson	Malachi Richardson
Spencer Hawes	Spencer Hawes
Marcus Morris	Marcus Morris
Shawn Marion	Shawn Marion
Alex Len	Alex Len
Taj Gibson	Taj Gibson
Aron Baynes	Aron Baynes
Larry Sanders	Larry Sanders (basketball)
Allen Crabbe	Allen Crabbe
Anthony Bennett	Anthony Bennett (basketball)
Joey Dorsey	Joey Dorsey
Kelly Oubre Jr.	Kelly Oubre Jr.
Gorgui Dieng	Gorgui Dieng
Will Barton	Will Barton
Rashad Vaughn	Rashad Vaughn
Jeff Ayres	Jeff Ayres
Clippers	Los Angeles Clippers
Shawn Long	Shawn Long
Sergio Rodriguez	Sergio Rodriguez
Ian Mahinmi	Ian Mahinmi
DeAndre Jordan	DeAndre Jordan
Rodney Hood	Rodney Hood
Anthony Morrow	Anthony Morrow
Karl-Anthony Towns	Karl-Anthony Towns
Jordan Hamilton	Jordan Hamilton (basketball)
Corey Brewer	Corey Brewer
Sonny Weems	Sonny Weems
Eric Bledsoe	Eric Bledsoe
Ryan Hollins	Ryan Hollins
Jason Richardson	Jason Richardson
Nikola Jokic	Nikola Jokic
Derrick Rose	Derrick Rose
CJ McCollum	CJ McCollum
John Wall	John Wall
Kevin Garnett	Kevin Garnett
Chasson Randle	Chasson Randle
Joe Harris	Joe Harris (basketball)
D.J. Augustin	D.J. Augustin
Hedo Turkoglu	Hedo Turkoglu
Tony Wroten	Tony Wroten
Kyrie Irving	Kyrie Irving
Stephen Curry	Stephen Curry
Tony Parker	Tony Parker
Ian Clark	Ian Clark (basketball)
Nene	Nenê
Ryan Kelly	Ryan Kelly (basketball)
Jae Crowder	Jae Crowder
Festus Ezeli	Festus Ezeli
James Harden	James Harden
Evan Fournier	Evan Fournier
Channing Frye	Channing Frye
Kenneth Faried	Kenneth Faried
Dante Exum	Dante Exum
Andrew Bogut	Andrew Bogut
Brandan Wright	Brandan Wright
Patrick Beverley	Patrick Beverley
Cory Joseph	Cory Joseph
Ivica Zubac	Ivica Zubac
O.J. Mayo	O.J. Mayo
Kings	Sacramento Kings
Brian Roberts	Brian Roberts (basketball)
Caron Butler	Caron Butler
Arron Afflalo	Arron Afflalo
Darrun Hilliard	Darrun Hilliard
Clint Capela	Clint Capela
Pablo Prigioni	Pablo Prigioni
Eric Gordon	Eric Gordon
James Michael McAdoo	James Michael McAdoo
Tyler Ennis	Tyler Ennis (basketball)
Pierre Jackson	Pierre Jackson
Hassan Whiteside	Hassan Whiteside
Giannis Antetokounmpo	Giannis Antetokounmpo
Cory Jefferson	Cory Jefferson
Kelly Olynyk	Kelly Olynyk
Thon Maker	Thon Maker
Elijah Millsap	Elijah Millsap
Greg Monroe	Greg Monroe
Dejounte Murray	Dejounte Murray
Sheldon McClellan	Sheldon McClellan
Jonathon Simmons	Jonathon Simmons
Delon Wright	Delon Wright
Zaza Pachulia	Zaza Pachulia
Beno Udrih	Beno Udrih
Kent Bazemore	Kent Bazemore
Chandler Parsons	Chandler Parsons
Tobias Harris	Tobias Harris
Anderson Varejao	Anderson Varejao
Reggie Bullock	Reggie Bullock
Will Bynum	Will Bynum
Norris Cole	Norris Cole
Kostas Papanikolaou	Kostas Papanikolaou
Timothe Luwawu-Cabarrot	Timothe Luwawu-Cabarrot
Tony Allen	Tony Allen (basketball)
Jeremy Lin	Jeremy Lin
Marcus Thornton	Marcus Thornton (basketball, born 1987)
Wesley Matthews	Wesley Matthews
Darren Collison	Darren Collison
Jerami Grant	Jerami Grant
Warriors	Golden State Warriors
Manu Ginobili	Manu Ginobili
Magic	Orlando Magic
Tyus Jones	Tyus Jones
76ers	Philadelphia 76ers
Willie Green	Willie Green
Reggie Evans	Reggie Evans
Larry Nance Jr.	Larry Nance Jr.
Austin Rivers	Austin Rivers
T.J. McConnell	T.J. McConnell
Sean Kilpatrick	Sean Kilpatrick
Fred VanVleet	Fred VanVleet
Vince Carter	Vince Carter
Jabari Parker	Jabari Parker
Paul George	Paul George
Amar'e Stoudemire	Amar'e Stoudemire
Khris Middleton	Khris Middleton
Robbie Hummel	Robbie Hummel
Tyler Hansbrough	Tyler Hansbrough
Matt Bonner	Matt Bonner
Archie Goodwin	Archie Goodwin (basketball)
Kenyon Martin	Kenyon Martin
Joel Freeland	Joel Freeland
Lou Amundson	Lou Amundson
Nemanja Bjelica	Nemanja Bjelica
Andre Miller	Andre Miller
Jamal Murray	Jamal Murray
KJ McDaniels	KJ McDaniels
Jeff Green	Jeff Green (basketball)
PJ Hairston	PJ Hairston
Sasha Vujacic	Sasha Vujacic
Nick Calathes	Nick Calathes
Dewayne Dedmon	Dewayne Dedmon
David Lee	David Lee (basketball)
Shawne Williams	Shawne Williams
Furkan Aldemir	Furkan Aldemir
John Jenkins	John Jenkins (basketball)
Cole Aldrich	Cole Aldrich
Nuggets	Denver Nuggets
Pacers	Indiana Pacers
Brandon Rush	Brandon Rush
Nikola Mirotic	Nikola Mirotic
Ronnie Price	Ronnie Price
Chris Paul	Chris Paul
Willie Cauley-Stein	Willie Cauley-Stein
D'Angelo Russell	D'Angelo Russell
Johnny O'Bryant III	Johnny O'Bryant III
DeMar DeRozan	DeMar DeRozan
Andre Iguodala	Andre Iguodala
Danilo Gallinari	Danilo Gallinari
Dwight Buycks	Dwight Buycks
Elton Brand	Elton Brand
Cleanthony Early	Cleanthony Early
Gordon Hayward	Gordon Hayward
Jazz	Utah Jazz
Mike Scott	Mike Scott (basketball)
Gary Neal	Gary Neal
Ben Gordon	Ben Gordon
Miles Plumlee	Miles Plumlee
Sam Dekker	Sam Dekker
Marcelo Huertas	Marcelo Huertas
Gigi Datome	Gigi Datome
Jordan Hill	Jordan Hill (basketball)
Tyler Ulis	Tyler Ulis
Lakers	Los Angeles Lakers
Meyers Leonard	Meyers Leonard
Kirk Hinrich	Kirk Hinrich
Paul Zipser	Paul Zipser
Wayne Ellington	Wayne Ellington
Luis Scola	Luis Scola
Michael Carter-Williams	Michael Carter-Williams
Klay Thompson	Klay Thompson
Kosta Koufos	Kosta Koufos
Dorell Wright	Dorell Wright
Mike Muscala	Mike Muscala
Andrea Bargnani	Andrea Bargnani
Kobe Bryant	Kobe Bryant
Serge Ibaka	Serge Ibaka
Courtney Lee	Courtney Lee
Gal Mekel	Gal Mekel
Terrence Ross	Terrence Ross
Jarell Martin	Jarell Martin
Randy Foye	Randy Foye
Juan Hernangomez	Juancho Hernangómez
Bulls	Chicago Bulls
Brandon Bass	Brandon Bass
Anthony Tolliver	Anthony Tolliver
Jimmy Butler	Jimmy Butler
JJ Redick	JJ Redick
DeJuan Blair	DeJuan Blair
Jerome Jordan	Jerome Jordan
Lance Thomas	Lance Thomas
Nate Wolters	Nate Wolters
Michael Kidd-Gilchrist	Michael Kidd-Gilchrist
Bojan Bogdanovic	Bojan Bogdanovic
JJ Hickson	JJ Hickson
Kay Felder	Kay Felder
Tim Frazier	Tim Frazier
Nets	Brooklyn Nets
Marco Belinelli	Marco Belinelli
Aaron Gordon	Aaron Gordon
Ben McLemore	Ben McLemore
Rodney Stuckey	Rodney Stuckey
Robert Sacre	Robert Sacre
Landry Fields	Landry Fields
Trey Lyles	Trey Lyles
Jonas Valanciunas	Jonas Valanciunas
James Ennis III	James Ennis III
Tim Hardaway Jr.	Tim Hardaway Jr.
Nicolas Brussino	Nicolas Brussino
Lance Stephenson	Lance Stephenson
Bryce Dejean-Jones	Bryce Dejean-Jones
Mario Hezonja	Mario Hezonja
Amir Johnson	Amir Johnson
Luc Mbah a Moute	Luc Mbah a Moute
Cody Zeller	Cody Zeller
Stanley Johnson	Stanley Johnson (basketball)
Kyle Lowry	Kyle Lowry
Jakob Poeltl	Jakob Poeltl
Alec Burks	Alec Burks
Jorge Gutierrez	Jorge Gutierrez (basketball)
Matthew Dellavedova	Matthew Dellavedova
Seth Curry	Seth Curry
LeBron James	LeBron James
Trevor Ariza	Trevor Ariza
Gerald Henderson	Gerald Henderson
Buddy Hield	Buddy Hield
CJ Miles	CJ Miles
Tyson Chandler	Tyson Chandler
Wilson Chandler	Wilson Chandler
Justin Anderson	Justin Anderson (basketball)
Kris Humphries	Kris Humphries
Bernard James	Bernard James
Tim Duncan	Tim Duncan
Mario Chalmers	Mario Chalmers
Gerald Green	Gerald Green
Salah Mejri	Salah Mejri
Damien Inglis	Damien Inglis
Ty Lawson	Ty Lawson
Bobby Portis	Bobby Portis
Mason Plumlee	Mason Plumlee
Luke Babbitt	Luke Babbitt
Russell Westbrook	Russell Westbrook
Mike Conley	Mike Conley (basketball)
Rasual Butler	Rasual Butler
Mo Williams	Mo Williams
Jared Dudley	Jared Dudley
Timberwolves	Minnesota Timberwolves
Isaiah Thomas	Isaiah Thomas (basketball)
Joe Young	Joe Young (basketball)
Cheick Diallo	Cheick Diallo
Mike Dunleavy	Mike Dunleavy Jr.
Andrew Harrison	Andrew Harrison (basketball)
Thaddeus Young	Thaddeus Young
Travis Wear	Travis Wear
James Young	James Young (basketball)
Kevin Seraphin	Kevin Seraphin
Ricky Ledo	Ricky Ledo
Chris Andersen	Chris Andersen
Marreese Speights	Marreese Speights
Dahntay Jones	Dahntay Jones
Willy Hernangomez	Willy Hernangomez
Steve Blake	Steve Blake
Darrell Arthur	Darrell Arthur
John Lucas III	John Lucas III
Noah Vonleh	Noah Vonleh
TJ Warren	TJ Warren
Suns	Phoenix Suns
Marcin Gortat	Marcin Gortat
Jordan Clarkson	Jordan Clarkson
Thabo Sefolosha	Thabo Sefolosha
Julius Randle	Julius Randle
Nik Stauskas	Nik Stauskas
Devin Booker	Devin Booker
Glenn Robinson III	Glenn Robinson III
Damjan Rudez	Damjan Rudez
Frank Kaminsky	Frank Kaminsky
Kentavious Caldwell-Pope	Kentavious Caldwell-Pope
Kyle Korver	Kyle Korver
Maurice Harkless	Maurice Harkless
Dorian Finney-Smith	Dorian Finney-Smith
Cavaliers	Cleveland Cavaliers
Nick Young	Nick Young (basketball)
Semaj Christon	Semaj Christon
Pistons	Detroit Pistons
Kris Dunn	Kris Dunn
Iman Shumpert	Iman Shumpert
Andrew Nicholson	Andrew Nicholson (basketball)
Otto Porter	Otto Porter
Alex Stepheson	Alex Stepheson
Kyle Singler	Kyle Singler
Richard Jefferson	Richard Jefferson
Damian Lillard	Damian Lillard
Jrue Holiday	Jrue Holiday
Boris Diaw	Boris Diaw
JaVale McGee	JaVale McGee
Marvin Williams	Marvin Williams
Carlos Boozer	Carlos Boozer
Trevor Booker	Trevor Booker
Norman Powell	Norman Powell
Rondae Hollis-Jefferson	Rondae Hollis-Jefferson
Lou Williams	Lou Williams
Dennis Schroder	Dennis Schroder
Justin Holiday	Justin Holiday
Ryan Anderson	Ryan Anderson (basketball, born 1988)
Tomas Satoransky	Tomas Satoransky
Isaiah Whitehead	Isaiah Whitehead
Tyler Zeller	Tyler Zeller
Spencer Dinwiddie	Spencer Dinwiddie
Kemba Walker	Kemba Walker
Steve Novak	Steve Novak
Malcolm Delaney	Malcolm Delaney
Jaylen Brown	Jaylen Brown
Shabazz Muhammad	Shabazz Muhammad
Joel Embiid	Joel Embiid
Andre Drummond	Andre Drummond
Andre Roberson	Andre Roberson
Draymond Green	Draymond Green
Jimmer Fredette	Jimmer Fredette
Glenn Robinson	Glenn Robinson
Nick Johnson	Nick Johnson (basketball)
Tyler Johnson	Tyler Johnson (basketball)
Jabari Brown	Jabari Brown
Jarrett Jack	Jarrett Jack
Ersan Ilyasova	Ersan Ilyasova
Markieff Morris	Markieff Morris
Victor Oladipo	Victor Oladipo
Tony Snell	Tony Snell (basketball)
Alexis Ajinca	Alexis Ajinca
Anthony Davis	Anthony Davis
Kevin Love	Kevin Love
Wesley Johnson	Wesley Johnson (basketball)
Matt Barnes	Matt Barnes
Willie Reed	Willie Reed
Robert Covington	Robert Covington
Alexey Shved	Alexey Shved
Paul Pierce	Paul Pierce
Jose Calderon	Jose Calderon (basketball)
Mitch McGary	Mitch McGary
JaKarr Sampson	JaKarr Sampson
Drew Gooden	Drew Gooden
Rudy Gobert	Rudy Gobert
Lucas Nogueira	Lucas Nogueira
Caris LeVert	Caris LeVert
Devyn Marble	Devyn Marble
Charlie Villanueva	Charlie Villanueva
Ron Baker	Ron Baker (basketball)
Josh Smith	Josh Smith
Steven Adams	Steven Adams
Patrick Patterson	Patrick Patterson (basketball)
Metta World Peace	Metta World Peace
Ramon Sessions	Ramon Sessions
Alex Abrines	Alex Abrines
Bismack Biyombo	Bismack Biyombo
Kristaps Porzingis	Kristaps Porzingis
Jeff Teague	Jeff Teague
Luol Deng	Luol Deng
Brandon Knight	Brandon Knight (basketball)
Carmelo Anthony	Carmelo Anthony
Zach Randolph	Zach Randolph
Avery Bradley	Avery Bradley
Georgios Papagiannis	Georgios Papagiannis
Alan Williams	Alan Williams (basketball)
Goran Dragic	Goran Dragic
Leandro Barbosa	Leandro Barbosa
Elliot Williams	Elliot Williams
Pascal Siakam	Pascal Siakam
Danny Green	Danny Green (basketball)
Monta Ellis	Monta Ellis
Al Horford	Al Horford
Thunder	Oklahoma City Thunder
DeMarcus Cousins	DeMarcus Cousins
George Hill	George Hill (basketball)
Brandon Davies	Brandon Davies
DeMarre Carroll	DeMarre Carroll
Trey Burke	Trey Burke
Jahlil Okafor	Jahlil Okafor
Richaun Holmes	Richaun Holmes
Jason Smith	Jason Smith (basketball, born 1986)
Derrick Favors	Derrick Favors
Zach LaVine	Zach LaVine
Hawks	Atlanta Hawks
Nikola Vucevic	Nikola Vucevic
Rakeem Christmas	Rakeem Christmas
Kyle O'Quinn	Kyle O'Quinn
Derrick Williams	Derrick Williams (basketball)
Devin Harris	Devin Harris
Tiago Splitter	Tiago Splitter
Chris Johnson	Chris Johnson (basketball, born 1985)
Trail Blazers	Portland Trail Blazers
Ish Smith	Ish Smith
Jeff Withey	Jeff Withey
James Anderson	James Anderson (basketball)
Jared Sullinger	Jared Sullinger
Dante Cunningham	Dante Cunningham
JR Smith	JR Smith
Jordan Farmar	Jordan Farmar
Alonzo Gee	Alonzo Gee
Jeremy Evans	Jeremy Evans
Ricky Rubio	Ricky Rubio
Wizards	Washington Wizards
Henry Walker	Henry Walker (basketball)
Joffrey Lauvergne	Joffrey Lauvergne
Greivis Vasquez	Greivis Vasquez
Jeremy Lamb	Jeremy Lamb
Dwight Powell	Dwight Powell
JaMychal Green	JaMychal Green
Udonis Haslem	Udonis Haslem
Nick Collison	Nick Collison
Shelvin Mack	Shelvin Mack
Roy Hibbert	Roy Hibbert
Nate Robinson	Nate Robinson
Joakim Noah	Joakim Noah
Shabazz Napier	Shabazz Napier
Dion Waiters	Dion Waiters
James Johnson	James Johnson (basketball, born 1987)
Dwight Howard	Dwight Howard
Bryce Cotton	Bryce Cotton
Jerryd Bayless	Jerryd Bayless
Enes Kanter	Enes Kanter
Jannero Pargo	Jannero Pargo
Chris Kaman	Chris Kaman
Langston Galloway	Langston Galloway
Boban Marjanovic	Boban Marjanovic
TJ McConnell	TJ McConnell
Myles Turner	Myles Turner
Shaun Livingston	Shaun Livingston
Donatas Motiejunas	Donatas Motiejunas
Nikola Pekovic	Nikola Pekovic
Andrew Wiggins	Andrew Wiggins
Jonathan Gibson	Jonathan Gibson (basketball)
Rodney McGruder	Rodney McGruder
Brandon Ingram	Brandon Ingram
Lavoy Allen	Lavoy Allen
Raptors	Toronto Raptors
Phil Pressey	Phil Pressey
Mavericks	Dallas Mavericks
Knicks	New York Knicks
Terrence Jones	Terrence Jones
Celtics	Boston Celtics
Chris Douglas-Roberts	Chris Douglas-Roberts
Mirza Teletovic	Mirza Teletovic
Paul Millsap	Paul Millsap
James Jones	James Jones (basketball, born 1980)
Dragan Bender	Dragan Bender
Chris Bosh	Chris Bosh
Bradley Beal	Bradley Beal
Toney Douglas	Toney Douglas
RJ Hunter	RJ Hunter
Nerlens Noel	Nerlens Noel
Donald Sloan	Donald Sloan (basketball)
Taurean Prince	Taurean Prince
David West	David West (basketball)
Dirk Nowitzki	Dirk Nowitzki
Jake Layman	Jake Layman
Tayshaun Prince	Tayshaun Prince
Jason Thompson	Jason Thompson (basketball)
Tyreke Evans	Tyreke Evans
Jordan Adams	Jordan Adams
Michael Beasley	Michael Beasley
Omri Casspi	Omri Casspi
C.J. Watson	C.J. Watson
Montrezl Harrell	Montrezl Harrell
Samuel Dalembert	Samuel Dalembert
Hornets	Charlotte Hornets
Otto Porter Jr.	Otto Porter Jr.
Skal Labissiere	Skal Labissiere
Jamal Crawford	Jamal Crawford
Quincy Pondexter	Quincy Pondexter
Jameer Nelson	Jameer Nelson
Kendrick Perkins	Kendrick Perkins
Jordan Crawford	Jordan Crawford
Thomas Robinson	Thomas Robinson (basketball)
Harrison Barnes	Harrison Barnes
Justin Hamilton	Justin Hamilton (basketball, born 1990)
Raymond Felton	Raymond Felton
Garrett Temple	Garrett Temple
